11111
11E11
1C001
10001
1P001
11111